PlanetsAspect,buy,sell,daysN,BuyDays%,SellDays%
JUNE_a103,6,12,18,0.33,0.67
JUNE_a120,35,51,86,0.41,0.59
JUNE_a135,10,7,17,0.59,0.41
JUNE_a144,12,10,22,0.55,0.45
JUNE_a150,22,28,50,0.44,0.56
JUNE_a45,11,8,19,0.58,0.42
JUNE_a60,54,58,112,0.48,0.52
JUNE_a72,9,10,19,0.47,0.53
JUNE_a90,45,42,87,0.52,0.48
JUPL_a0,66,53,119,0.55,0.45
JUPL_a30,77,53,130,0.59,0.41
JUPL_a36,50,68,118,0.42,0.58
JUPL_a45,8,13,21,0.38,0.62
JUPL_a60,59,48,107,0.55,0.45
JUPL_a72,10,11,21,0.48,0.52
JUPL_a90,16,10,26,0.62,0.38
JUSA_a0,21,16,37,0.57,0.43
JUSA_a30,68,92,160,0.42,0.57
JUSA_a36,14,17,31,0.45,0.55
JUSA_a45,76,80,156,0.49,0.51
JUSA_a60,13,10,23,0.57,0.43
JUSA_a72,9,14,23,0.39,0.61
JUUR_a103,46,41,87,0.53,0.47
JUUR_a120,6,10,16,0.38,0.62
JUUR_a135,37,28,65,0.57,0.43
JUUR_a144,12,19,31,0.39,0.61
JUUR_a150,8,8,16,0.5,0.5
JUUR_a180,10,6,16,0.62,0.38
JUUR_a90,7,4,11,0.64,0.36
MAJU_a0,9,6,15,0.6,0.4
MAJU_a103,14,6,20,0.7,0.3
MAJU_a120,6,9,15,0.4,0.6
MAJU_a135,5,7,12,0.42,0.58
MAJU_a144,4,8,12,0.33,0.67
MAJU_a150,7,5,12,0.58,0.42
MAJU_a180,0,6,6,0,1
MAJU_a30,14,19,33,0.42,0.58
MAJU_a36,14,18,32,0.44,0.56
MAJU_a45,16,14,30,0.53,0.47
MAJU_a60,16,15,31,0.52,0.48
MAJU_a72,43,34,77,0.56,0.44
MAJU_a90,22,25,47,0.47,0.53
MANE_a0,4,10,14,0.29,0.71
MANE_a103,13,8,21,0.62,0.38
MANE_a120,15,12,27,0.56,0.44
MANE_a135,13,13,26,0.5,0.5
MANE_a144,15,12,27,0.56,0.44
MANE_a150,11,14,25,0.44,0.56
MANE_a180,9,3,12,0.75,0.25
MANE_a30,30,33,63,0.48,0.52
MANE_a36,41,50,91,0.45,0.55
MANE_a45,38,45,83,0.46,0.54
MANE_a60,15,7,22,0.68,0.32
MANE_a72,13,8,21,0.62,0.38
MANE_a90,10,11,21,0.48,0.52
MAPL_a0,10,5,15,0.67,0.33
MAPL_a103,12,9,21,0.57,0.43
MAPL_a120,13,7,20,0.65,0.35
MAPL_a135,7,14,21,0.33,0.67
MAPL_a144,10,10,20,0.5,0.5
MAPL_a150,4,17,21,0.19,0.81
MAPL_a180,5,8,13,0.38,0.62
MAPL_a30,15,12,27,0.56,0.44
MAPL_a36,13,14,27,0.48,0.52
MAPL_a45,12,14,26,0.46,0.54
MAPL_a60,15,12,27,0.56,0.44
MAPL_a72,17,10,27,0.63,0.37
MAPL_a90,29,26,55,0.53,0.47
MASA_a0,7,8,15,0.47,0.53
MASA_a103,13,7,20,0.65,0.35
MASA_a120,9,11,20,0.45,0.55
MASA_a135,8,10,18,0.44,0.56
MASA_a144,9,10,19,0.47,0.53
MASA_a150,6,13,19,0.32,0.68
MASA_a180,4,2,6,0.67,0.33
MASA_a30,32,39,71,0.45,0.55
MASA_a36,19,12,31,0.61,0.39
MASA_a45,22,9,31,0.71,0.29
MASA_a60,15,15,30,0.5,0.5
MASA_a72,16,15,31,0.52,0.48
MASA_a90,28,38,66,0.42,0.58
MAUR_a0,7,3,10,0.7,0.3
MAUR_a103,18,12,30,0.6,0.4
MAUR_a120,11,17,28,0.39,0.61
MAUR_a135,18,7,25,0.72,0.28
MAUR_a144,15,12,27,0.56,0.44
MAUR_a150,12,14,26,0.46,0.54
MAUR_a180,5,8,13,0.38,0.62
MAUR_a30,10,11,21,0.48,0.52
MAUR_a36,14,7,21,0.67,0.33
MAUR_a45,9,11,20,0.45,0.55
MAUR_a60,8,13,21,0.38,0.62
MAUR_a72,11,16,27,0.41,0.59
MAUR_a90,24,37,61,0.39,0.61
MEJU_a0,11,9,20,0.55,0.45
MEJU_a103,8,11,19,0.42,0.58
MEJU_a120,7,10,17,0.41,0.59
MEJU_a135,30,19,49,0.61,0.39
MEJU_a144,17,10,27,0.63,0.37
MEJU_a150,9,7,16,0.56,0.44
MEJU_a180,2,5,7,0.29,0.71
MEJU_a30,22,19,41,0.54,0.46
MEJU_a36,35,21,56,0.62,0.38
MEJU_a45,31,35,66,0.47,0.53
MEJU_a60,9,11,20,0.45,0.55
MEJU_a72,9,19,28,0.32,0.68
MEJU_a90,15,21,36,0.42,0.58
MEMA_a0,14,16,30,0.47,0.53
MEMA_a103,23,25,48,0.48,0.52
MEMA_a120,9,4,13,0.69,0.31
MEMA_a135,3,8,11,0.27,0.73
MEMA_a144,2,9,11,0.18,0.82
MEMA_a150,5,6,11,0.45,0.55
MEMA_a180,3,3,6,0.5,0.5
MEMA_a30,15,20,35,0.43,0.57
MEMA_a36,23,12,35,0.66,0.34
MEMA_a45,24,18,42,0.57,0.43
MEMA_a60,15,20,35,0.43,0.57
MEMA_a72,26,16,42,0.62,0.38
MEMA_a90,26,15,41,0.63,0.37
MENE_a0,21,5,26,0.81,0.19
MENE_a103,14,24,38,0.37,0.63
MENE_a120,23,8,31,0.74,0.26
MENE_a135,24,25,49,0.49,0.51
MENE_a144,15,13,28,0.54,0.46
MENE_a150,16,18,34,0.47,0.53
MENE_a180,6,8,14,0.43,0.57
MENE_a30,14,17,31,0.45,0.55
MENE_a36,6,14,20,0.3,0.7
MENE_a45,8,11,19,0.42,0.58
MENE_a60,8,11,19,0.42,0.58
MENE_a72,16,12,28,0.57,0.43
MENE_a90,20,20,40,0.5,0.5
MEPL_a0,8,3,11,0.73,0.27
MEPL_a103,10,7,17,0.59,0.41
MEPL_a120,6,11,17,0.35,0.65
MEPL_a135,15,13,28,0.54,0.46
MEPL_a144,12,10,22,0.55,0.45
MEPL_a150,16,17,33,0.48,0.52
MEPL_a180,4,7,11,0.36,0.64
MEPL_a30,14,13,27,0.52,0.48
MEPL_a36,33,23,56,0.59,0.41
MEPL_a45,22,14,36,0.61,0.39
MEPL_a60,19,20,39,0.49,0.51
MEPL_a72,21,21,42,0.5,0.5
MEPL_a90,5,12,17,0.29,0.71
MESA_a0,15,11,26,0.58,0.42
MESA_a103,14,17,31,0.45,0.55
MESA_a120,6,13,19,0.32,0.68
MESA_a135,11,19,30,0.37,0.63
MESA_a144,12,7,19,0.63,0.37
MESA_a150,13,9,22,0.59,0.41
MESA_a180,6,3,9,0.67,0.33
MESA_a30,20,24,44,0.45,0.55
MESA_a36,21,19,40,0.52,0.48
MESA_a45,18,16,34,0.53,0.47
MESA_a60,21,18,39,0.54,0.46
MESA_a72,24,11,35,0.69,0.31
MESA_a90,20,21,41,0.49,0.51
MESU_a0,33,50,83,0.4,0.6
MEUR_a0,2,6,8,0.25,0.75
MEUR_a103,20,13,33,0.61,0.39
MEUR_a120,24,20,44,0.55,0.45
MEUR_a135,15,17,32,0.47,0.53
MEUR_a144,20,10,30,0.67,0.33
MEUR_a150,17,19,36,0.47,0.53
MEUR_a180,14,11,25,0.56,0.44
MEUR_a30,16,12,28,0.57,0.43
MEUR_a36,12,13,25,0.48,0.52
MEUR_a45,18,14,32,0.56,0.44
MEUR_a60,17,24,41,0.41,0.59
MEUR_a72,12,6,18,0.67,0.33
MEUR_a90,15,15,30,0.5,0.5
MEVE_a0,19,15,34,0.56,0.44
MEVE_a30,54,57,111,0.49,0.51
MEVE_a36,43,42,85,0.51,0.49
MEVE_a45,26,46,72,0.36,0.64
MEVE_a60,27,23,50,0.54,0.46
MEVE_a72,12,12,24,0.5,0.5
MOJU_a0,24,27,51,0.47,0.53
MOJU_a103,47,51,98,0.48,0.52
MOJU_a120,46,49,95,0.48,0.52
MOJU_a135,49,47,96,0.51,0.49
MOJU_a144,53,45,98,0.54,0.46
MOJU_a150,53,42,95,0.56,0.44
MOJU_a180,29,19,48,0.6,0.4
MOJU_a30,49,50,99,0.49,0.51
MOJU_a36,42,55,97,0.43,0.57
MOJU_a45,48,51,99,0.48,0.52
MOJU_a60,53,46,99,0.54,0.46
MOJU_a72,49,52,101,0.49,0.51
MOJU_a90,39,57,96,0.41,0.59
MOMA_a0,24,25,49,0.49,0.51
MOMA_a103,43,51,94,0.46,0.54
MOMA_a120,45,51,96,0.47,0.53
MOMA_a135,49,47,96,0.51,0.49
MOMA_a144,60,35,95,0.63,0.37
MOMA_a150,58,38,96,0.6,0.4
MOMA_a180,25,23,48,0.52,0.48
MOMA_a30,42,54,96,0.44,0.56
MOMA_a36,37,58,95,0.39,0.61
MOMA_a45,51,45,96,0.53,0.47
MOMA_a60,45,49,94,0.48,0.52
MOMA_a72,42,54,96,0.44,0.56
MOMA_a90,62,33,95,0.65,0.35
MOME_a0,19,27,46,0.41,0.59
MOME_a103,47,47,94,0.5,0.5
MOME_a120,51,44,95,0.54,0.46
MOME_a135,51,43,94,0.54,0.46
MOME_a144,49,44,93,0.53,0.47
MOME_a150,52,42,94,0.55,0.45
MOME_a180,18,28,46,0.39,0.61
MOME_a30,51,41,92,0.55,0.45
MOME_a36,40,50,90,0.44,0.56
MOME_a45,43,51,94,0.46,0.54
MOME_a60,45,50,95,0.47,0.53
MOME_a72,46,45,91,0.51,0.49
MOME_a90,49,42,91,0.54,0.46
MONE_a0,21,29,50,0.42,0.58
MONE_a103,47,50,97,0.48,0.52
MONE_a120,52,46,98,0.53,0.47
MONE_a135,46,51,97,0.47,0.53
MONE_a144,45,52,97,0.46,0.54
MONE_a150,51,46,97,0.53,0.47
MONE_a180,24,24,48,0.5,0.5
MONE_a30,42,59,101,0.42,0.58
MONE_a36,53,48,101,0.52,0.48
MONE_a45,45,55,100,0.45,0.55
MONE_a60,57,44,101,0.56,0.44
MONE_a72,46,56,102,0.45,0.55
MONE_a90,55,42,97,0.57,0.43
MOPL_a0,28,21,49,0.57,0.43
MOPL_a103,48,50,98,0.49,0.51
MOPL_a120,49,46,95,0.52,0.48
MOPL_a135,43,50,93,0.46,0.54
MOPL_a144,49,47,96,0.51,0.49
MOPL_a150,53,41,94,0.56,0.44
MOPL_a180,28,20,48,0.58,0.42
MOPL_a30,48,53,101,0.48,0.52
MOPL_a36,58,42,100,0.58,0.42
MOPL_a45,50,51,101,0.5,0.5
MOPL_a60,46,53,99,0.46,0.54
MOPL_a72,43,56,99,0.43,0.57
MOPL_a90,46,54,100,0.46,0.54
MOSA_a0,27,22,49,0.55,0.45
MOSA_a103,47,49,96,0.49,0.51
MOSA_a120,45,51,96,0.47,0.53
MOSA_a135,49,47,96,0.51,0.49
MOSA_a144,44,52,96,0.46,0.54
MOSA_a150,52,45,97,0.54,0.46
MOSA_a180,28,20,48,0.58,0.42
MOSA_a30,48,52,100,0.48,0.52
MOSA_a36,49,51,100,0.49,0.51
MOSA_a45,46,52,98,0.47,0.53
MOSA_a60,45,56,101,0.45,0.55
MOSA_a72,45,55,100,0.45,0.55
MOSA_a90,54,45,99,0.55,0.45
MOSU_a0,22,23,45,0.49,0.51
MOSU_a103,53,38,91,0.58,0.42
MOSU_a120,48,47,95,0.51,0.49
MOSU_a135,49,44,93,0.53,0.47
MOSU_a144,40,52,92,0.43,0.57
MOSU_a150,44,50,94,0.47,0.53
MOSU_a180,22,23,45,0.49,0.51
MOSU_a30,42,53,95,0.44,0.56
MOSU_a36,42,52,94,0.45,0.55
MOSU_a45,40,52,92,0.43,0.57
MOSU_a60,49,47,96,0.51,0.49
MOSU_a72,48,46,94,0.51,0.49
MOSU_a90,42,51,93,0.45,0.55
MOUR_a0,22,29,51,0.43,0.57
MOUR_a103,55,42,97,0.57,0.43
MOUR_a120,41,56,97,0.42,0.58
MOUR_a135,49,49,98,0.5,0.5
MOUR_a144,48,50,98,0.49,0.51
MOUR_a150,48,51,99,0.48,0.52
MOUR_a180,23,27,50,0.46,0.54
MOUR_a30,47,52,99,0.47,0.53
MOUR_a36,50,49,99,0.51,0.49
MOUR_a45,56,46,102,0.55,0.45
MOUR_a60,60,39,99,0.61,0.39
MOUR_a72,53,45,98,0.54,0.46
MOUR_a90,47,50,97,0.48,0.52
MOVE_a0,22,22,44,0.5,0.5
MOVE_a103,48,42,90,0.53,0.47
MOVE_a120,43,49,92,0.47,0.53
MOVE_a135,44,50,94,0.47,0.53
MOVE_a144,46,44,90,0.51,0.49
MOVE_a150,48,45,93,0.52,0.48
MOVE_a180,28,19,47,0.6,0.4
MOVE_a30,44,49,93,0.47,0.53
MOVE_a36,46,49,95,0.48,0.52
MOVE_a45,44,47,91,0.48,0.52
MOVE_a60,49,43,92,0.53,0.47
MOVE_a72,54,40,94,0.57,0.43
MOVE_a90,49,45,94,0.52,0.48
SANE_a45,15,7,22,0.68,0.32
SANE_a60,81,88,169,0.48,0.52
SANE_a72,88,75,163,0.54,0.46
SAPL_a0,29,19,48,0.6,0.4
SAUR_a103,142,147,289,0.49,0.51
SAUR_a120,53,60,113,0.47,0.53
SUJU_a0,9,7,16,0.56,0.44
SUJU_a103,18,16,34,0.53,0.47
SUJU_a120,15,14,29,0.52,0.48
SUJU_a135,11,14,25,0.44,0.56
SUJU_a144,8,18,26,0.31,0.69
SUJU_a150,13,11,24,0.54,0.46
SUJU_a180,4,8,12,0.33,0.67
SUJU_a30,23,15,38,0.61,0.39
SUJU_a36,24,13,37,0.65,0.35
SUJU_a45,21,15,36,0.58,0.42
SUJU_a60,24,12,36,0.67,0.33
SUJU_a72,16,19,35,0.46,0.54
SUJU_a90,15,17,32,0.47,0.53
SUMA_a0,15,12,27,0.56,0.44
SUMA_a103,23,12,35,0.66,0.34
SUMA_a120,13,12,25,0.52,0.48
SUMA_a135,8,11,19,0.42,0.58
SUMA_a144,6,11,17,0.35,0.65
SUMA_a150,6,10,16,0.38,0.62
SUMA_a180,2,6,8,0.25,0.75
SUMA_a30,12,25,37,0.32,0.68
SUMA_a36,17,18,35,0.49,0.51
SUMA_a45,22,12,34,0.65,0.35
SUMA_a60,16,19,35,0.46,0.54
SUMA_a72,20,16,36,0.56,0.44
SUMA_a90,17,17,34,0.5,0.5
SUNE_a0,8,6,14,0.57,0.43
SUNE_a103,15,20,35,0.43,0.57
SUNE_a120,16,17,33,0.48,0.52
SUNE_a135,20,16,36,0.56,0.44
SUNE_a144,16,20,36,0.44,0.56
SUNE_a150,18,16,34,0.53,0.47
SUNE_a180,6,10,16,0.38,0.62
SUNE_a30,11,15,26,0.42,0.58
SUNE_a36,13,15,28,0.46,0.54
SUNE_a45,14,14,28,0.5,0.5
SUNE_a60,18,13,31,0.58,0.42
SUNE_a72,11,20,31,0.35,0.65
SUNE_a90,13,22,35,0.37,0.63
SUPL_a0,12,8,20,0.6,0.4
SUPL_a103,18,12,30,0.6,0.4
SUPL_a120,12,19,31,0.39,0.61
SUPL_a135,15,18,33,0.45,0.55
SUPL_a144,19,14,33,0.58,0.42
SUPL_a150,12,22,34,0.35,0.65
SUPL_a180,7,11,18,0.39,0.61
SUPL_a30,16,12,28,0.57,0.43
SUPL_a36,15,13,28,0.54,0.46
SUPL_a45,14,15,29,0.48,0.52
SUPL_a60,13,19,32,0.41,0.59
SUPL_a72,15,16,31,0.48,0.52
SUPL_a90,16,16,32,0.5,0.5
SUSA_a0,8,6,14,0.57,0.43
SUSA_a103,12,19,31,0.39,0.61
SUSA_a120,17,14,31,0.55,0.45
SUSA_a135,10,20,30,0.33,0.67
SUSA_a144,8,22,30,0.27,0.73
SUSA_a150,13,17,30,0.43,0.57
SUSA_a180,8,10,18,0.44,0.56
SUSA_a30,11,20,31,0.35,0.65
SUSA_a36,15,17,32,0.47,0.53
SUSA_a45,15,17,32,0.47,0.53
SUSA_a60,18,15,33,0.55,0.45
SUSA_a72,22,10,32,0.69,0.31
SUSA_a90,13,19,32,0.41,0.59
SUUR_a0,10,4,14,0.71,0.29
SUUR_a103,25,10,35,0.71,0.29
SUUR_a120,13,21,34,0.38,0.62
SUUR_a135,12,22,34,0.35,0.65
SUUR_a144,16,17,33,0.48,0.52
SUUR_a150,13,21,34,0.38,0.62
SUUR_a180,6,10,16,0.38,0.62
SUUR_a30,13,15,28,0.46,0.54
SUUR_a36,12,15,27,0.44,0.56
SUUR_a45,13,14,27,0.48,0.52
SUUR_a60,16,18,34,0.47,0.53
SUUR_a72,17,16,33,0.52,0.48
SUUR_a90,13,18,31,0.42,0.58
URNE_a45,367,378,745,0.49,0.51
URPL_a103,232,225,457,0.51,0.49
VEJU_a0,4,10,14,0.29,0.71
VEJU_a103,19,9,28,0.68,0.32
VEJU_a120,11,15,26,0.42,0.58
VEJU_a135,19,26,45,0.42,0.58
VEJU_a144,27,25,52,0.52,0.48
VEJU_a150,8,18,26,0.31,0.69
VEJU_a180,4,6,10,0.4,0.6
VEJU_a30,21,21,42,0.5,0.5
VEJU_a36,28,30,58,0.48,0.52
VEJU_a45,21,11,32,0.66,0.34
VEJU_a60,18,11,29,0.62,0.38
VEJU_a72,17,10,27,0.63,0.37
VEJU_a90,15,14,29,0.52,0.48
VEMA_a0,5,9,14,0.36,0.64
VEMA_a103,16,24,40,0.4,0.6
VEMA_a120,30,26,56,0.54,0.46
VEMA_a135,9,8,17,0.53,0.47
VEMA_a144,5,11,16,0.31,0.69
VEMA_a150,5,10,15,0.33,0.67
VEMA_a180,3,4,7,0.43,0.57
VEMA_a30,16,13,29,0.55,0.45
VEMA_a36,17,11,28,0.61,0.39
VEMA_a45,17,13,30,0.57,0.43
VEMA_a60,16,21,37,0.43,0.57
VEMA_a72,16,18,34,0.47,0.53
VEMA_a90,17,29,46,0.37,0.63
VENE_a0,4,8,12,0.33,0.67
VENE_a103,13,18,31,0.42,0.58
VENE_a120,23,8,31,0.74,0.26
VENE_a135,28,20,48,0.58,0.42
VENE_a144,15,16,31,0.48,0.52
VENE_a150,13,17,30,0.43,0.57
VENE_a180,8,6,14,0.57,0.43
VENE_a30,10,10,20,0.5,0.5
VENE_a36,13,9,22,0.59,0.41
VENE_a45,13,14,27,0.48,0.52
VENE_a60,15,13,28,0.54,0.46
VENE_a72,22,10,32,0.69,0.31
VENE_a90,20,36,56,0.36,0.64
VEPL_a0,6,5,11,0.55,0.45
VEPL_a103,13,16,29,0.45,0.55
VEPL_a120,16,15,31,0.52,0.48
VEPL_a135,27,22,49,0.55,0.45
VEPL_a144,20,32,52,0.38,0.62
VEPL_a150,12,16,28,0.43,0.57
VEPL_a180,4,10,14,0.29,0.71
VEPL_a30,14,14,28,0.5,0.5
VEPL_a36,16,12,28,0.57,0.43
VEPL_a45,14,10,24,0.58,0.42
VEPL_a60,13,11,24,0.54,0.46
VEPL_a72,22,21,43,0.51,0.49
VEPL_a90,15,14,29,0.52,0.48
VESA_a0,8,3,11,0.73,0.27
VESA_a103,15,10,25,0.6,0.4
VESA_a120,17,10,27,0.63,0.37
VESA_a135,34,14,48,0.71,0.29
VESA_a144,12,19,31,0.39,0.61
VESA_a150,14,16,30,0.47,0.53
VESA_a180,3,9,12,0.25,0.75
VESA_a30,12,16,28,0.43,0.57
VESA_a36,19,9,28,0.68,0.32
VESA_a45,14,14,28,0.5,0.5
VESA_a60,25,15,40,0.62,0.38
VESA_a72,16,28,44,0.36,0.64
VESA_a90,7,17,24,0.29,0.71
VESU_a0,16,22,38,0.42,0.58
VESU_a30,49,57,106,0.46,0.54
VESU_a36,62,60,122,0.51,0.49
VESU_a45,128,151,279,0.46,0.54
VEUR_a0,6,8,14,0.43,0.57
VEUR_a103,13,14,27,0.48,0.52
VEUR_a120,15,16,31,0.48,0.52
VEUR_a135,16,14,30,0.53,0.47
VEUR_a144,8,22,30,0.27,0.73
VEUR_a150,18,11,29,0.62,0.38
VEUR_a180,15,18,33,0.45,0.55
VEUR_a30,23,20,43,0.53,0.47
VEUR_a36,26,14,40,0.65,0.35
VEUR_a45,16,28,44,0.36,0.64
VEUR_a60,14,13,27,0.52,0.48
VEUR_a72,15,11,26,0.58,0.42
VEUR_a90,13,12,25,0.52,0.48
