PlanetsAspect,buy,sell,daysN,BuyDays%,SellDays%
JUNE_a0,63,48,111,0.57,0.43
JUNE_a103,119,107,226,0.53,0.47
JUNE_a120,128,98,226,0.57,0.43
JUNE_a135,100,103,203,0.49,0.51
JUNE_a144,119,102,221,0.54,0.46
JUNE_a150,152,135,287,0.53,0.47
JUNE_a180,79,77,156,0.51,0.49
JUNE_a30,95,75,170,0.56,0.44
JUNE_a36,126,118,244,0.52,0.48
JUNE_a45,110,120,230,0.48,0.52
JUNE_a60,116,97,213,0.54,0.46
JUNE_a72,159,136,295,0.54,0.46
JUNE_a90,128,110,238,0.54,0.46
JUPL_a0,72,59,131,0.55,0.45
JUPL_a103,144,143,287,0.5,0.5
JUPL_a120,122,90,212,0.58,0.42
JUPL_a135,130,111,241,0.54,0.46
JUPL_a144,85,80,165,0.52,0.48
JUPL_a150,114,98,212,0.54,0.46
JUPL_a180,78,55,133,0.59,0.41
JUPL_a30,95,67,162,0.59,0.41
JUPL_a36,148,147,295,0.5,0.5
JUPL_a45,140,170,310,0.45,0.55
JUPL_a60,66,74,140,0.47,0.53
JUPL_a72,148,146,294,0.5,0.5
JUPL_a90,105,95,200,0.52,0.48
JUSA_a0,83,95,178,0.47,0.53
JUSA_a103,125,114,239,0.52,0.48
JUSA_a120,120,114,234,0.51,0.49
JUSA_a135,100,96,196,0.51,0.49
JUSA_a144,104,102,206,0.5,0.5
JUSA_a150,70,64,134,0.52,0.48
JUSA_a180,79,77,156,0.51,0.49
JUSA_a30,140,113,253,0.55,0.45
JUSA_a36,135,124,259,0.52,0.48
JUSA_a45,140,118,258,0.54,0.46
JUSA_a60,153,137,290,0.53,0.47
JUSA_a72,150,163,313,0.48,0.52
JUSA_a90,121,112,233,0.52,0.48
JUUR_a0,117,98,215,0.54,0.46
JUUR_a103,128,108,236,0.54,0.46
JUUR_a120,133,115,248,0.54,0.46
JUUR_a135,106,78,184,0.58,0.42
JUUR_a144,166,143,309,0.54,0.46
JUUR_a150,130,103,233,0.56,0.44
JUUR_a180,77,40,117,0.66,0.34
JUUR_a30,204,163,367,0.56,0.44
JUUR_a36,136,99,235,0.58,0.42
JUUR_a45,122,119,241,0.51,0.49
JUUR_a60,128,125,253,0.51,0.49
JUUR_a72,111,113,224,0.5,0.5
JUUR_a90,130,99,229,0.57,0.43
MAJU_a0,46,63,109,0.42,0.58
MAJU_a103,97,99,196,0.49,0.51
MAJU_a120,108,102,210,0.51,0.49
MAJU_a135,92,100,192,0.48,0.52
MAJU_a144,113,99,212,0.53,0.47
MAJU_a150,120,94,214,0.56,0.44
MAJU_a180,87,76,163,0.53,0.47
MAJU_a30,122,108,230,0.53,0.47
MAJU_a36,114,92,206,0.55,0.45
MAJU_a45,135,102,237,0.57,0.43
MAJU_a60,153,127,280,0.55,0.45
MAJU_a72,173,126,299,0.58,0.42
MAJU_a90,130,109,239,0.54,0.46
MANE_a0,45,39,84,0.54,0.46
MANE_a103,103,102,205,0.5,0.5
MANE_a120,91,114,205,0.44,0.56
MANE_a135,144,123,267,0.54,0.46
MANE_a144,132,135,267,0.49,0.51
MANE_a150,137,114,251,0.55,0.45
MANE_a180,58,67,125,0.46,0.54
MANE_a30,122,95,217,0.56,0.44
MANE_a36,132,114,246,0.54,0.46
MANE_a45,130,132,262,0.5,0.5
MANE_a60,109,80,189,0.58,0.42
MANE_a72,87,110,197,0.44,0.56
MANE_a90,120,125,245,0.49,0.51
MAPL_a0,58,39,97,0.6,0.4
MAPL_a103,108,104,212,0.51,0.49
MAPL_a120,117,101,218,0.54,0.46
MAPL_a135,138,141,279,0.49,0.51
MAPL_a144,132,108,240,0.55,0.45
MAPL_a150,141,125,266,0.53,0.47
MAPL_a180,55,53,108,0.51,0.49
MAPL_a30,124,100,224,0.55,0.45
MAPL_a36,99,106,205,0.48,0.52
MAPL_a45,127,103,230,0.55,0.45
MAPL_a60,118,100,218,0.54,0.46
MAPL_a72,145,99,244,0.59,0.41
MAPL_a90,130,122,252,0.52,0.48
MASA_a0,60,55,115,0.52,0.48
MASA_a103,95,94,189,0.5,0.5
MASA_a120,106,98,204,0.52,0.48
MASA_a135,118,80,198,0.6,0.4
MASA_a144,113,114,227,0.5,0.5
MASA_a150,100,108,208,0.48,0.52
MASA_a180,70,55,125,0.56,0.44
MASA_a30,145,114,259,0.56,0.44
MASA_a36,141,112,253,0.56,0.44
MASA_a45,153,130,283,0.54,0.46
MASA_a60,136,107,243,0.56,0.44
MASA_a72,103,121,224,0.46,0.54
MASA_a90,117,132,249,0.47,0.53
MAUR_a0,59,59,118,0.5,0.5
MAUR_a103,134,123,257,0.52,0.48
MAUR_a120,117,103,220,0.53,0.47
MAUR_a135,113,129,242,0.47,0.53
MAUR_a144,153,125,278,0.55,0.45
MAUR_a150,131,148,279,0.47,0.53
MAUR_a180,63,62,125,0.5,0.5
MAUR_a30,128,96,224,0.57,0.43
MAUR_a36,97,81,178,0.54,0.46
MAUR_a45,109,90,199,0.55,0.45
MAUR_a60,129,127,256,0.5,0.5
MAUR_a72,112,96,208,0.54,0.46
MAUR_a90,123,106,229,0.54,0.46
MEJU_a0,65,69,134,0.49,0.51
MEJU_a103,112,116,228,0.49,0.51
MEJU_a120,106,90,196,0.54,0.46
MEJU_a135,109,109,218,0.5,0.5
MEJU_a144,113,117,230,0.49,0.51
MEJU_a150,109,95,204,0.53,0.47
MEJU_a180,46,35,81,0.57,0.43
MEJU_a30,156,114,270,0.58,0.42
MEJU_a36,155,129,284,0.55,0.45
MEJU_a45,144,150,294,0.49,0.51
MEJU_a60,148,96,244,0.61,0.39
MEJU_a72,130,127,257,0.51,0.49
MEJU_a90,140,102,242,0.58,0.42
MEMA_a0,107,89,196,0.55,0.45
MEMA_a103,119,121,240,0.5,0.5
MEMA_a120,78,52,130,0.6,0.4
MEMA_a135,42,52,94,0.45,0.55
MEMA_a144,37,44,81,0.46,0.54
MEMA_a150,52,36,88,0.59,0.41
MEMA_a180,16,21,37,0.43,0.57
MEMA_a30,208,182,390,0.53,0.47
MEMA_a36,159,170,329,0.48,0.52
MEMA_a45,229,193,422,0.54,0.46
MEMA_a60,150,130,280,0.54,0.46
MEMA_a72,175,148,323,0.54,0.46
MEMA_a90,133,108,241,0.55,0.45
MENE_a0,76,52,128,0.59,0.41
MENE_a103,120,102,222,0.54,0.46
MENE_a120,134,115,249,0.54,0.46
MENE_a135,144,121,265,0.54,0.46
MENE_a144,116,99,215,0.54,0.46
MENE_a150,101,97,198,0.51,0.49
MENE_a180,68,55,123,0.55,0.45
MENE_a30,148,106,254,0.58,0.42
MENE_a36,133,123,256,0.52,0.48
MENE_a45,119,122,241,0.49,0.51
MENE_a60,123,102,225,0.55,0.45
MENE_a72,141,138,279,0.51,0.49
MENE_a90,133,130,263,0.51,0.49
MEPL_a0,70,72,142,0.49,0.51
MEPL_a103,118,126,244,0.48,0.52
MEPL_a120,116,123,239,0.49,0.51
MEPL_a135,104,101,205,0.51,0.49
MEPL_a144,115,126,241,0.48,0.52
MEPL_a150,119,99,218,0.55,0.45
MEPL_a180,54,40,94,0.57,0.43
MEPL_a30,120,122,242,0.5,0.5
MEPL_a36,142,143,285,0.5,0.5
MEPL_a45,140,114,254,0.55,0.45
MEPL_a60,137,126,263,0.52,0.48
MEPL_a72,143,108,251,0.57,0.43
MEPL_a90,125,116,241,0.52,0.48
MESA_a0,72,60,132,0.55,0.45
MESA_a103,127,129,256,0.5,0.5
MESA_a120,123,102,225,0.55,0.45
MESA_a135,134,116,250,0.54,0.46
MESA_a144,125,99,224,0.56,0.44
MESA_a150,105,99,204,0.51,0.49
MESA_a180,51,38,89,0.57,0.43
MESA_a30,126,132,258,0.49,0.51
MESA_a36,130,118,248,0.52,0.48
MESA_a45,149,140,289,0.52,0.48
MESA_a60,141,107,248,0.57,0.43
MESA_a72,159,129,288,0.55,0.45
MESA_a90,116,124,240,0.48,0.52
MESU_a0,356,270,626,0.57,0.43
MEUR_a0,64,64,128,0.5,0.5
MEUR_a103,118,108,226,0.52,0.48
MEUR_a120,133,110,243,0.55,0.45
MEUR_a135,109,139,248,0.44,0.56
MEUR_a144,122,116,238,0.51,0.49
MEUR_a150,125,123,248,0.5,0.5
MEUR_a180,61,51,112,0.54,0.46
MEUR_a30,131,143,274,0.48,0.52
MEUR_a36,134,114,248,0.54,0.46
MEUR_a45,129,133,262,0.49,0.51
MEUR_a60,144,117,261,0.55,0.45
MEUR_a72,131,118,249,0.53,0.47
MEUR_a90,122,122,244,0.5,0.5
MEVE_a0,190,193,383,0.5,0.5
MEVE_a30,389,352,741,0.52,0.48
MEVE_a36,331,320,651,0.51,0.49
MEVE_a45,270,244,514,0.53,0.47
MEVE_a60,231,204,435,0.53,0.47
MEVE_a72,45,46,91,0.49,0.51
MOJU_a0,179,179,358,0.5,0.5
MOJU_a103,378,363,741,0.51,0.49
MOJU_a120,412,351,763,0.54,0.46
MOJU_a135,387,382,769,0.5,0.5
MOJU_a144,397,374,771,0.51,0.49
MOJU_a150,408,356,764,0.53,0.47
MOJU_a180,198,159,357,0.55,0.45
MOJU_a30,397,377,774,0.51,0.49
MOJU_a36,409,371,780,0.52,0.48
MOJU_a45,409,368,777,0.53,0.47
MOJU_a60,399,351,750,0.53,0.47
MOJU_a72,376,342,718,0.52,0.48
MOJU_a90,376,352,728,0.52,0.48
MOMA_a0,204,153,357,0.57,0.43
MOMA_a103,377,354,731,0.52,0.48
MOMA_a120,375,346,721,0.52,0.48
MOMA_a135,372,357,729,0.51,0.49
MOMA_a144,350,371,721,0.49,0.51
MOMA_a150,364,357,721,0.5,0.5
MOMA_a180,189,174,363,0.52,0.48
MOMA_a30,381,350,731,0.52,0.48
MOMA_a36,378,343,721,0.52,0.48
MOMA_a45,382,354,736,0.52,0.48
MOMA_a60,388,343,731,0.53,0.47
MOMA_a72,406,326,732,0.55,0.45
MOMA_a90,381,354,735,0.52,0.48
MOME_a0,204,158,362,0.56,0.44
MOME_a103,368,318,686,0.54,0.46
MOME_a120,389,343,732,0.53,0.47
MOME_a135,390,316,706,0.55,0.45
MOME_a144,375,314,689,0.54,0.46
MOME_a150,374,326,700,0.53,0.47
MOME_a180,183,166,349,0.52,0.48
MOME_a30,371,340,711,0.52,0.48
MOME_a36,369,344,713,0.52,0.48
MOME_a45,369,350,719,0.51,0.49
MOME_a60,365,329,694,0.53,0.47
MOME_a72,368,359,727,0.51,0.49
MOME_a90,395,309,704,0.56,0.44
MONE_a0,186,182,368,0.51,0.49
MONE_a103,399,353,752,0.53,0.47
MONE_a120,395,352,747,0.53,0.47
MONE_a135,401,352,753,0.53,0.47
MONE_a144,391,358,749,0.52,0.48
MONE_a150,401,338,739,0.54,0.46
MONE_a180,185,191,376,0.49,0.51
MONE_a30,405,355,760,0.53,0.47
MONE_a36,414,335,749,0.55,0.45
MONE_a45,376,376,752,0.5,0.5
MONE_a60,402,345,747,0.54,0.46
MONE_a72,405,346,751,0.54,0.46
MONE_a90,368,373,741,0.5,0.5
MOPL_a0,199,181,380,0.52,0.48
MOPL_a103,421,330,751,0.56,0.44
MOPL_a120,388,362,750,0.52,0.48
MOPL_a135,390,368,758,0.51,0.49
MOPL_a144,382,363,745,0.51,0.49
MOPL_a150,404,350,754,0.54,0.46
MOPL_a180,204,171,375,0.54,0.46
MOPL_a30,378,377,755,0.5,0.5
MOPL_a36,359,381,740,0.49,0.51
MOPL_a45,382,370,752,0.51,0.49
MOPL_a60,386,351,737,0.52,0.48
MOPL_a72,390,358,748,0.52,0.48
MOPL_a90,419,343,762,0.55,0.45
MOSA_a0,195,183,378,0.52,0.48
MOSA_a103,394,365,759,0.52,0.48
MOSA_a120,394,364,758,0.52,0.48
MOSA_a135,409,353,762,0.54,0.46
MOSA_a144,402,347,749,0.54,0.46
MOSA_a150,397,346,743,0.53,0.47
MOSA_a180,185,173,358,0.52,0.48
MOSA_a30,379,367,746,0.51,0.49
MOSA_a36,375,365,740,0.51,0.49
MOSA_a45,367,362,729,0.5,0.5
MOSA_a60,412,336,748,0.55,0.45
MOSA_a72,393,332,725,0.54,0.46
MOSA_a90,386,367,753,0.51,0.49
MOSU_a0,196,163,359,0.55,0.45
MOSU_a103,382,331,713,0.54,0.46
MOSU_a120,378,337,715,0.53,0.47
MOSU_a135,371,334,705,0.53,0.47
MOSU_a144,360,341,701,0.51,0.49
MOSU_a150,372,331,703,0.53,0.47
MOSU_a180,182,177,359,0.51,0.49
MOSU_a30,364,342,706,0.52,0.48
MOSU_a36,372,336,708,0.53,0.47
MOSU_a45,350,353,703,0.5,0.5
MOSU_a60,338,382,720,0.47,0.53
MOSU_a72,384,331,715,0.54,0.46
MOSU_a90,376,341,717,0.52,0.48
MOUR_a0,205,176,381,0.54,0.46
MOUR_a103,396,351,747,0.53,0.47
MOUR_a120,380,368,748,0.51,0.49
MOUR_a135,385,365,750,0.51,0.49
MOUR_a144,396,356,752,0.53,0.47
MOUR_a150,395,366,761,0.52,0.48
MOUR_a180,182,195,377,0.48,0.52
MOUR_a30,391,354,745,0.52,0.48
MOUR_a36,393,353,746,0.53,0.47
MOUR_a45,411,349,760,0.54,0.46
MOUR_a60,399,348,747,0.53,0.47
MOUR_a72,381,370,751,0.51,0.49
MOUR_a90,401,356,757,0.53,0.47
MOVE_a0,191,157,348,0.55,0.45
MOVE_a103,344,361,705,0.49,0.51
MOVE_a120,360,338,698,0.52,0.48
MOVE_a135,372,346,718,0.52,0.48
MOVE_a144,382,323,705,0.54,0.46
MOVE_a150,381,323,704,0.54,0.46
MOVE_a180,190,155,345,0.55,0.45
MOVE_a30,374,341,715,0.52,0.48
MOVE_a36,384,327,711,0.54,0.46
MOVE_a45,383,328,711,0.54,0.46
MOVE_a60,375,338,713,0.53,0.47
MOVE_a72,367,334,701,0.52,0.48
MOVE_a90,363,342,705,0.51,0.49
NEPL_a60,689,709,1398,0.49,0.51
SANE_a0,99,86,185,0.54,0.46
SANE_a103,118,107,225,0.52,0.48
SANE_a120,139,109,248,0.56,0.44
SANE_a135,74,69,143,0.52,0.48
SANE_a144,92,76,168,0.55,0.45
SANE_a150,107,109,216,0.5,0.5
SANE_a180,44,27,71,0.62,0.38
SANE_a30,128,120,248,0.52,0.48
SANE_a36,123,154,277,0.44,0.56
SANE_a45,122,138,260,0.47,0.53
SANE_a60,170,160,330,0.52,0.48
SANE_a72,138,132,270,0.51,0.49
SANE_a90,109,98,207,0.53,0.47
SAPL_a0,64,64,128,0.5,0.5
SAPL_a103,79,88,167,0.47,0.53
SAPL_a120,110,93,203,0.54,0.46
SAPL_a135,73,84,157,0.46,0.54
SAPL_a144,106,81,187,0.57,0.43
SAPL_a150,102,92,194,0.53,0.47
SAPL_a180,44,48,92,0.48,0.52
SAPL_a30,148,117,265,0.56,0.44
SAPL_a36,103,96,199,0.52,0.48
SAPL_a45,112,112,224,0.5,0.5
SAPL_a60,111,112,223,0.5,0.5
SAPL_a72,122,101,223,0.55,0.45
SAPL_a90,111,121,232,0.48,0.52
SAUR_a0,108,123,231,0.47,0.53
SAUR_a103,201,155,356,0.56,0.44
SAUR_a120,121,82,203,0.6,0.4
SAUR_a135,142,109,251,0.57,0.43
SAUR_a144,138,133,271,0.51,0.49
SAUR_a150,131,98,229,0.57,0.43
SAUR_a180,67,67,134,0.5,0.5
SAUR_a30,155,177,332,0.47,0.53
SAUR_a36,169,171,340,0.5,0.5
SAUR_a45,138,151,289,0.48,0.52
SAUR_a60,61,82,143,0.43,0.57
SAUR_a72,57,53,110,0.52,0.48
SAUR_a90,45,35,80,0.56,0.44
SUJU_a0,70,65,135,0.52,0.48
SUJU_a103,149,90,239,0.62,0.38
SUJU_a120,106,114,220,0.48,0.52
SUJU_a135,109,103,212,0.51,0.49
SUJU_a144,99,114,213,0.46,0.54
SUJU_a150,122,86,208,0.59,0.41
SUJU_a180,44,53,97,0.45,0.55
SUJU_a30,145,134,279,0.52,0.48
SUJU_a36,155,116,271,0.57,0.43
SUJU_a45,136,127,263,0.52,0.48
SUJU_a60,133,125,258,0.52,0.48
SUJU_a72,127,122,249,0.51,0.49
SUJU_a90,122,117,239,0.51,0.49
SUMA_a0,97,101,198,0.49,0.51
SUMA_a103,92,101,193,0.48,0.52
SUMA_a120,70,67,137,0.51,0.49
SUMA_a135,65,54,119,0.55,0.45
SUMA_a144,54,45,99,0.55,0.45
SUMA_a150,43,56,99,0.43,0.57
SUMA_a180,27,20,47,0.57,0.43
SUMA_a30,185,167,352,0.53,0.47
SUMA_a36,178,181,359,0.5,0.5
SUMA_a45,183,156,339,0.54,0.46
SUMA_a60,164,154,318,0.52,0.48
SUMA_a72,162,134,296,0.55,0.45
SUMA_a90,122,114,236,0.52,0.48
SUNE_a0,52,64,116,0.45,0.55
SUNE_a103,126,122,248,0.51,0.49
SUNE_a120,122,118,240,0.51,0.49
SUNE_a135,124,113,237,0.52,0.48
SUNE_a144,138,122,260,0.53,0.47
SUNE_a150,144,111,255,0.56,0.44
SUNE_a180,59,55,114,0.52,0.48
SUNE_a30,146,93,239,0.61,0.39
SUNE_a36,141,104,245,0.58,0.42
SUNE_a45,122,113,235,0.52,0.48
SUNE_a60,129,117,246,0.52,0.48
SUNE_a72,126,117,243,0.52,0.48
SUNE_a90,121,129,250,0.48,0.52
SUPL_a0,62,57,119,0.52,0.48
SUPL_a103,133,119,252,0.53,0.47
SUPL_a120,136,114,250,0.54,0.46
SUPL_a135,124,116,240,0.52,0.48
SUPL_a144,133,117,250,0.53,0.47
SUPL_a150,116,123,239,0.49,0.51
SUPL_a180,73,43,116,0.63,0.37
SUPL_a30,136,99,235,0.58,0.42
SUPL_a36,123,116,239,0.51,0.49
SUPL_a45,136,95,231,0.59,0.41
SUPL_a60,136,111,247,0.55,0.45
SUPL_a72,152,89,241,0.63,0.37
SUPL_a90,135,111,246,0.55,0.45
SUSA_a0,77,55,132,0.58,0.42
SUSA_a103,116,125,241,0.48,0.52
SUSA_a120,105,124,229,0.46,0.54
SUSA_a135,98,127,225,0.44,0.56
SUSA_a144,118,104,222,0.53,0.47
SUSA_a150,119,92,211,0.56,0.44
SUSA_a180,53,53,106,0.5,0.5
SUSA_a30,134,130,264,0.51,0.49
SUSA_a36,120,141,261,0.46,0.54
SUSA_a45,125,127,252,0.5,0.5
SUSA_a60,133,118,251,0.53,0.47
SUSA_a72,128,110,238,0.54,0.46
SUSA_a90,136,105,241,0.56,0.44
SUUR_a0,60,62,122,0.49,0.51
SUUR_a103,123,114,237,0.52,0.48
SUUR_a120,110,130,240,0.46,0.54
SUUR_a135,121,119,240,0.5,0.5
SUUR_a144,112,122,234,0.48,0.52
SUUR_a150,116,116,232,0.5,0.5
SUUR_a180,64,50,114,0.56,0.44
SUUR_a30,121,125,246,0.49,0.51
SUUR_a36,133,115,248,0.54,0.46
SUUR_a45,131,109,240,0.55,0.45
SUUR_a60,128,113,241,0.53,0.47
SUUR_a72,126,116,242,0.52,0.48
SUUR_a90,119,124,243,0.49,0.51
URNE_a0,258,269,527,0.49,0.51
URNE_a30,334,258,592,0.56,0.44
URNE_a36,335,268,603,0.56,0.44
URNE_a45,324,240,564,0.57,0.43
URPL_a103,195,124,319,0.61,0.39
URPL_a36,244,238,482,0.51,0.49
URPL_a45,298,282,580,0.51,0.49
URPL_a60,303,336,639,0.47,0.53
URPL_a72,308,287,595,0.52,0.48
URPL_a90,311,209,520,0.6,0.4
VEJU_a0,77,72,149,0.52,0.48
VEJU_a103,131,107,238,0.55,0.45
VEJU_a120,131,111,242,0.54,0.46
VEJU_a135,110,112,222,0.5,0.5
VEJU_a144,119,110,229,0.52,0.48
VEJU_a150,109,105,214,0.51,0.49
VEJU_a180,61,52,113,0.54,0.46
VEJU_a30,130,125,255,0.51,0.49
VEJU_a36,147,128,275,0.53,0.47
VEJU_a45,131,107,238,0.55,0.45
VEJU_a60,131,130,261,0.5,0.5
VEJU_a72,157,125,282,0.56,0.44
VEJU_a90,138,112,250,0.55,0.45
VEMA_a0,122,128,250,0.49,0.51
VEMA_a103,138,132,270,0.51,0.49
VEMA_a120,125,84,209,0.6,0.4
VEMA_a135,62,42,104,0.6,0.4
VEMA_a144,47,49,96,0.49,0.51
VEMA_a150,37,54,91,0.41,0.59
VEMA_a180,24,22,46,0.52,0.48
VEMA_a30,161,147,308,0.52,0.48
VEMA_a36,143,155,298,0.48,0.52
VEMA_a45,158,167,325,0.49,0.51
VEMA_a60,159,151,310,0.51,0.49
VEMA_a72,116,117,233,0.5,0.5
VEMA_a90,144,99,243,0.59,0.41
VENE_a0,53,65,118,0.45,0.55
VENE_a103,127,116,243,0.52,0.48
VENE_a120,114,117,231,0.49,0.51
VENE_a135,126,122,248,0.51,0.49
VENE_a144,118,117,235,0.5,0.5
VENE_a150,131,112,243,0.54,0.46
VENE_a180,68,45,113,0.6,0.4
VENE_a30,131,121,252,0.52,0.48
VENE_a36,133,109,242,0.55,0.45
VENE_a45,121,123,244,0.5,0.5
VENE_a60,119,110,229,0.52,0.48
VENE_a72,112,113,225,0.5,0.5
VENE_a90,144,106,250,0.58,0.42
VEPL_a0,63,59,122,0.52,0.48
VEPL_a103,120,109,229,0.52,0.48
VEPL_a120,131,95,226,0.58,0.42
VEPL_a135,130,120,250,0.52,0.48
VEPL_a144,132,134,266,0.5,0.5
VEPL_a150,132,94,226,0.58,0.42
VEPL_a180,64,52,116,0.55,0.45
VEPL_a30,114,112,226,0.5,0.5
VEPL_a36,138,106,244,0.57,0.43
VEPL_a45,126,114,240,0.52,0.48
VEPL_a60,134,102,236,0.57,0.43
VEPL_a72,155,103,258,0.6,0.4
VEPL_a90,128,115,243,0.53,0.47
VESA_a0,65,56,121,0.54,0.46
VESA_a103,144,132,276,0.52,0.48
VESA_a120,111,129,240,0.46,0.54
VESA_a135,118,130,248,0.48,0.52
VESA_a144,116,90,206,0.56,0.44
VESA_a150,116,86,202,0.57,0.43
VESA_a180,58,54,112,0.52,0.48
VESA_a30,130,111,241,0.54,0.46
VESA_a36,153,123,276,0.55,0.45
VESA_a45,126,102,228,0.55,0.45
VESA_a60,127,117,244,0.52,0.48
VESA_a72,131,112,243,0.54,0.46
VESA_a90,112,121,233,0.48,0.52
VESU_a0,180,148,328,0.55,0.45
VESU_a30,391,363,754,0.52,0.48
VESU_a36,455,441,896,0.51,0.49
VESU_a45,1142,979,2121,0.54,0.46
VEUR_a0,60,54,114,0.53,0.47
VEUR_a103,122,128,250,0.49,0.51
VEUR_a120,126,110,236,0.53,0.47
VEUR_a135,117,103,220,0.53,0.47
VEUR_a144,123,94,217,0.57,0.43
VEUR_a150,120,116,236,0.51,0.49
VEUR_a180,59,60,119,0.5,0.5
VEUR_a30,136,102,238,0.57,0.43
VEUR_a36,142,101,243,0.58,0.42
VEUR_a45,133,116,249,0.53,0.47
VEUR_a60,136,104,240,0.57,0.43
VEUR_a72,125,129,254,0.49,0.51
VEUR_a90,116,105,221,0.52,0.48
